NO      Wall.xpm
SO  Wall.xpm

WE      Wall.xpm
EA       Wall.xpm


C 125,6,250
F 0,2,255


11111111111111111111111111111111111111111111111
100000000000000000010000000000000000000000001
100000000000111100011000000000000000000000001
1000000000001  111101000000000000010000000001
1000000000001     1110000000000001 1000000001
1000000000001111111111000000000000100000000001
1000000000000000000001000000000000000000000001
1000000000000000001111111111111111111111111111
1000000000000000001111      1
1000000000000000001111      1
1000000000000000001111    11
10000000000000000011111111111
1000000000000000001111
10000000111000000000111111
100000001 10000000111111101
100N00000110000000111101101
111111111111111111111111111
