NO  aled
SO  sudferrer
WE      weekend?
EA        istmdr
F 0,250,6
C 6,6,654

1110000000000001111
1000000000000000001
1000000000000000001
1000000000000000001
100000001E100100001
1000000001000000001
1000000000000000001
1000000000000000001
1111111111111111111
