NO  aled.xpm
SO  aled.xpm
WE      aled.xpm
EA       aled.xpm
F 0,2,255
C 25,6,250

11111111111
10000000001
10000E00001
10000000001
10000000111
100000001
100000001
11111111
