NO  wall.xpm
SO  wall.xpm
WE      wall.xpm
EA        wall.xpm
F 0,250,6
C 6,6,250

11111111111110111111
1000000001000000001
1000000001000000001
10000000000000000001
100000001S100100001
100000000100000000111
1000000000000000000001
100000000000000000111
11111111111111111111
