NO  aled.xpm
SO  aled.xpm
WE      aled.xpm
EA       aled.xpm
F 0,2,255
C 25,6,250

1111111111
100000N0001
1111111111
