NO  eco.xpm
SO  aled.xpm
WE      aled.xpm
EA       Cr.xpm
F 0,2,255
C 125,6,250

11111111111111111111
10000000000000000001
100000000000011110001
1000000000001    111
100000001011
1000000001001111111111
1000E00000000000000001
1000000000000000001111
1111111111111111111111
