NO nord
SO  sudferrer
WE      weekend?
EA        istmdr
F 0,250,6
C 6,6,654

1111111111111111111
1000000001000000001
1000000001000000001
1000000100010000001
100000000S000100001
1000000000000000001
1000000000000000001
1000000000000000001
1111111111111111111