NO nord
SO  sudferrer
WE      weekend?
EA        istmdr
F 0,250,6
C 6,6,654

11111111
11000010111
100000001111
11000110100011
10111111111111
11111111111111
101000000000011
11S000000001011
11111111111111111