NO  wall.xpm
SO  wall.xpm
WE      wall.xpm
EA        wall.xpm
F 0,250,6
C 6,6,250

11111111111111111111
10000000000000000001
100000000000011110001
1000000000001    111
100000001011
1000000001001111111111
10000000000000000N0001
1000000000000000001111
1111111111111111111111
