NO  aled
SO  sudferrer
WE      weekend?
EA        istmdr
F 0,250,6
C 6,6,654

11111111111110111111
1000000001000000001
1000000001000000001
10000000000000000001
100000001N100100001
100000000100000000111
1000000000000000000001
100000000000000000111
11111111111111111111
