NO  eco.xpm
SO  aled.xpm
WE      wall.xpm
EA       Cr.xpm
F 0,2,255
C 125,6,250


11111111111111111111111111111111111111111111111
100000000000000000010000000000000000000000001
100000000000111100011000000000000000000000001
1000000000001  111101000000000000010000000001
1000000000001     1110000000000001 1000000001
1000000000001111111111000000000000100000000001
1000000000000000000001000000000000000000000001
1000000000000000001111111111111111111111111111
1000000000000000001111      1
1000000000000000001111      1
1000000000000000001111    11
10000000000000000011111111111
1000000000000000001111
100000001110000000001111
100000001 1000000011111
100N00000110000000111101
11111111111111111111111
