NO  eco.xpm
SO  aled.xpm
WE      wall.xpm
EA       Cr.xpm
F 0,2,255
C 125,6,250

11111111111111111111
10000000000000000001
10000000000011110001
1000000000001   1111
1000000000001
1000000000001111111111
1000E00000000000000001
1000000000000000001111
1000000000000000001111
1000000000000000001111
1000000000000000001111
1000000000000000001111
1000000000000000001111
100000001110000000001111
100000001 100000001111
1000000001100000001111
11111111111111111111111
