NO  aled
SO  sudferrer
WE      weekend?
EA        istmdr
F 0,250,6
C 6,6,654

11111111111111111111
1000000000000000001
1000000000000000001
10000000000000000001
1000000010100000001
100000000100000000111
10000000000000000N0001
100000000000000000111
11111111111111111111
