NO Cr.xpm
SO eco.xpm
WE aled.xpm
EA wall.xpm
F 220,abc,0
C 225,30,0

111111
100001
100N01
100001
111111
