NO Cr.xpm
SO eco.xpm
WE aled.xpm
EA wall.xpm
F 220,100,0
C 225,30,0

111111111
100000001
10    001
100N0001
100000001
111111111
