NO Cr.xpm
SO eco.xpm
WE aled.xpm
EA wall.xpm
F 220,100,0
C 225,30,0

11111111
10000001
100  001
10 N 001
100  001
10000001
11111111
