F 220,100,0
EA Cr.xpm
C 225,30,0
NO Cr.xpm
WE Cr.xpm
SO Cr.xpm

111111
100001
100N01
100001
111111
