NO Cr.xpm
SO eco.xpm
WE aled.xpm
EA wall.xpm
F 220,100,0
C 225,30,0

1111111111111111111111
1000000001100000000001
1011000001110000000001
1001000000000000000001
1000000110000001110001
1000000011000001110001
1111011111101110000001
1111011111101110101001
1100000011010101100001
1000000000000000110001
1000000000000000110101
1100000111010101111101
1111011111101011011111
  1111111111111111111
  111111111
  100000001
  100N00001
  100000001
  111111111
