NO Cr.xpm


SO Cr.xpm


WE Cr.xpm


EA Cr.xpm


F 220,100,0


C 225,30,0


111111
100001
100N01
100001
111111
