NO Cr.xpm
SO eco.xpm
WE aled.xpm
EA wall.xpm
F 255,255,255
C 0,0,0

111111
100001
100N01
100001
111111
