NO Cr.xpm
SO eco.xpm
WE aled.xpm
EA wall.xpm
F 220,100,0
C 225,30,0

11111
11111
11N11
11111
11111
