NO    eco.xpm
SO     eco.xpm
WE       eco.xpm
EA eco.xpm
F     220,100,0
C  225,30,0

111111
100001
100N01
100001
111111
