NO Cr.xpm
SO eco.xpm
WE aled.xpm
EA wall.xpm
F 220,100,0
C 225,30,0

1111111111
1000000001
10100N0001
1000000001
1111111111
