NO Cr.xpm
SO eco.xpm
WE aled.xpm
EA wall.xpm
F 220,100,0
C 225,30,0

11111111111111111111111
10000000001100000000001
10110000011100000000001
10010000000000000000001
11111111101100000111000
10000000001100000111011
11110111111111011100000
11110111111111011101010
11000000110101011100000
10000000000000001100000
10000000000000001101010
11000001110101011111011
11100111 1110101 101111
11101111 1111111 111111
  101
  101
  1N1
  111
