NO Cr.xpm
SO eco.xpm
WE aled.xpm
EA wall.xpm
F 220,100,0
C 225,30,0

11111111111111111111111
10000000001100000000001
10110000011100000000001
10010000000000000000001
111111111011000001110001
10000000001100000111011
111101111111110111000001
111101111111110111010101
110000001101010111000001
100000000000000011000001
1000000000000000110101011
11000001110101011111011
11100111 1110101 101111
11101111 1111111 111111
  101
  101
  1N1
  111
