NO Cr.xpm
SO eco.xpm
WE aled.xpm
EA wall.xpm
F 220,100,0
C 225,30,0

     111111111
     100000001
     100N00001
     100000001
     100111101
111111001  101
10000000111101
10000000000001
11111111111111
