NO Cr.xpm
SO eco.xpm
WE aled.xpm
EA wall.xpm
F 220,100,0
C 225,30,0

1111111111111
1000000000001
1010101010101
1010101010101
1000100N10001
1010111110101
1000000000001
1111111111111
